1 tablespoon canola oil	oil
1 3/4 pounds boneless, skinless chicken breast or thighs, cut in chunks	chunks
1 large yellow onion, chopped	onion
1 cup sliced celery	celery
1 cup thinly sliced carrots	carrots
3 cups no-salt-added chopped tomatoes	tomatoes
1 (14.25 ounce) can fat-free, less-sodium chicken broth	ounce
1 (15 ounce) can no-salt-added black beans	ounce
1 (15 ounce) can no salt-added navy beans	beans
1 (15 ounce) can no salt-added kidney beans	beans
1 cup dry red wine	wine
1 bay leaf	leaf
1 tablespoon Italian herbs	herbs
1 cup smoked chicken breast, cubed	breast
1 cup fresh Italian parsley, chopped	parsley
1 cup fresh cilantro, chopped	cilantro
2 tablespoons vegetable oil	oil
2 skinless chicken leg quarters	quarters
1/2 cup chopped onion	onion
2 quarts water	water
3 cubes  chicken bouillon, crumbled	bouillon
1 stalk celery, chopped	celery
3 carrots, chopped	carrots
1 clove roasted garlic, minced	clove
salt and pepper to taste	taste
1 (12 ounce) package thin egg noodles	ounce
6 (2 inch thick) slices French bread	inch
1/4 cup ricotta cheese	cheese
1/4 cup cottage cheese, whipped	cheese
2 tablespoons lowfat cream cheese	cheese
2 teaspoons white sugar	sugar
2 teaspoons vanilla extract	extract
3 cups egg substitute	substitute
1/4 cup evaporated milk	milk
1 (10 ounce) package frozen mixed berries	berries
1 (15 ounce) can sliced peaches, drained	peaches
2 tablespoons honey	honey
2 Yukon Gold potatoes, cubed	potatoes
1 (5.5 ounce) package au gratin instant potato mix	mix
1 (10.5 ounce) can condensed chicken broth	ounce
1 1/2 cups water	water
1 cup heavy cream	cream
1 cup brown sugar	sugar
1/2 cup chile sauce	sauce
1/2 cup rum	rum
1/4 cup soy sauce	sauce
1/4 cup ketchup	ketchup
1/4 cup Worcestershire sauce	sauce
2 cloves garlic, crushed	cloves
1 teaspoon ground dry mustard	mustard
ground black pepper to taste	taste
1 (3 pound) whole chicken, cut into 8 pieces	pieces
1/2 cup soy sauce	sauce
3/4 cup distilled white vinegar	vinegar
1 bulb garlic, peeled and crushed	bulb
2 tablespoons thinly sliced fresh ginger root	root
2 bay leaves	leaves
1/2 tablespoon black peppercorns	peppercorns
2 teaspoons peanut oil	oil
2 cloves garlic, thinly sliced	garlic
2 tablespoons grated fresh ginger root	root
1/4 cup chopped lemon grass	grass
2 teaspoons crushed red pepper	pepper
1 teaspoon ground coriander	coriander
1 teaspoon ground cumin	cumin
1 skinless, boneless chicken breast halves - cut into thin strips	strips
1 onion, thinly sliced	onion
2 cups bok choy, shredded	choy
4 cups water	water
1 (10 ounce) can coconut milk	milk
1/4 cup fish sauce	sauce
1/4 cup chopped fresh cilantro	cilantro
6 tablespoons butter or margarine, divided	margarine
1 1/2 pounds halibut steaks, bones removed and cut into 1 inch cubes	cubes
2 garlic cloves, minced	cloves
3/4 teaspoon dried thyme	thyme
1/3 cup all-purpose flour	flour
1/2 teaspoon salt	salt
1 1/2 cups chicken broth	broth
1 cup heavy whipping cream	cream
8 ounces lasagna noodles, cooked and drained	noodles
2 cups shredded Swiss cheese	cheese
Minced fresh parsley	parsley
1 1/2 pounds cubed beef stew meat	meat
2 cups water	water
1 small onion, chopped	onion
1 (28 ounce) can crushed tomatoes	tomatoes
1 (16 ounce) package frozen mixed vegetables	vegetables
2 potatoes, peeled and cubed	potatoes
10 cubes beef bouillon, crumbled	bouillon
2 teaspoons ground black pepper	pepper
1 tablespoon salt	salt
1 tablespoon dried basil	basil
2 1/2 cups all-purpose flour	flour
1/2 cup sugar	sugar
1/2 cup packed brown sugar	sugar
3 teaspoons baking powder	powder
1 teaspoon salt	salt
2 (4 ounce) jars apricot baby food, divided	ounce
1 egg	egg
3/4 cup milk	cup
3 tablespoons vegetable oil	oil
1 teaspoon almond extract	extract
2/3 cup sliced almonds, coarsely chopped	almonds
1/2 cup diced dried apricots	apricots
1/2 cup confectioners' sugar	sugar
1 teaspoon milk	milk
1/8 teaspoon almond extract	teaspoon
3/4 cup butter	butter
2 cups white sugar	sugar
1 cup chopped almonds	almonds
2 cups milk chocolate chips	chips
1/2 cup finely chopped almonds	almonds
1 cup quick cooking oats	oats
3/4 cup flaked coconut	coconut
1 cup all-purpose flour	flour
1 teaspoon baking soda	soda
1 cup white sugar	sugar
1/2 cup butter	butter
1 tablespoon golden syrup	syrup
2 tablespoons boiling water	water
2 medium cooking apples, peeled, cored, and chopped	apples
2/3 cup fresh or frozen blueberries	blueberries
1 tablespoon heat-stable granular sugar substitute	substitute
1/2 teaspoon apple pie spice or ground allspice	allspice
1 1/3 cups whole wheat pastry flour	wheat
1/4 teaspoon kosher salt	salt
1/3 cup extra-virgin olive oil	oil
3 tablespoons low-fat milk	milk
1 cup packed brown sugar	sugar
1 teaspoon ground cinnamon	cinnamon
1/2 teaspoon ground nutmeg	nutmeg
1/2 cup chopped pecans	pecans
2 cups all-purpose flour	flour
1 teaspoon baking powder	powder
1 teaspoon baking soda	soda
1/2 teaspoon salt	salt
1/2 cup butter, softened	butter
1 cup white sugar	sugar
3/4 cup apple butter	butter
1 teaspoon vanilla extract	extract
1/2 cup whole bran cereal or wheat germ	germ
1 cup sour cream	cream
2 eggs, beaten	eggs
6 pounds tart apples, cored and sliced	apples
6 cups apple cider	cider
3 cups white sugar	sugar
2 teaspoons ground cinnamon	cinnamon
1 teaspoon ground cloves	cloves
2 pounds Granny Smith apples - peeled, cored and thinly sliced	apples
3/4 cup cranberries	cranberries
1/4 cup white sugar	sugar
3 teaspoons ground cinnamon	cinnamon
1 teaspoon ground nutmeg	nutmeg
1/3 cup quick-cooking oats	oats
1/3 cup all-purpose flour	flour
1/2 cup packed light brown sugar	sugar
1/4 cup butter, cut into pieces	pieces
1/2 cup chopped pecans	pecans
1 gallon apple juice	juice
1 gallon apple cider	cider
3 cups white sugar	sugar
8 cinnamon sticks	sticks
1 (750 milliliter) bottle 190 proof grain alcohol	milliliter
3 cups all-purpose flour	flour
3 eggs	eggs
2 cups white sugar	cups
1 cup vegetable oil	vegetable
2 cups applesauce	cups
1 cup raisins (optional)	raisins
1 teaspoon ground cinnamon	cinnamon
1 teaspoon baking soda	soda
1/4 teaspoon baking powder	powder
1/2 cup sour cream	cream
1 cup water	water
1 1/2 tablespoons white wine vinegar	vinegar
3 tablespoons olive oil	oil
1/8 teaspoon cayenne pepper	pepper
3/4 teaspoon dried oregano	oregano
2 cloves garlic, minced	cloves
3 tablespoons chopped onion	onion
3 tablespoons fresh parsley	parsley
1 1/2 teaspoons salt	salt
1 tablespoon white sugar	sugar
3 tablespoons wheat bran	bran
3 cups bread flour	flour
2 teaspoons active dry yeast	yeast
24 jalapeno peppers	peppers
1 pound sausage	sausage
2 cups all-purpose baking mix	mix
1 (16 ounce) package Cheddar cheese, shredded	cheese
1 tablespoon crushed red pepper flakes	flakes
1 tablespoon garlic salt	salt
1 (16 ounce) package Monterey Jack cheese, cubed	cheese
1 (2 to 3 pound) whole chicken, cut into pieces	pieces
1 tablespoon olive oil	oil
2 onions, chopped	onions
3 cloves garlic, crushed	cloves
1/2 green bell pepper, chopped	pepper
1/2 (15 ounce) can tomato sauce	ounce
1 pinch saffron	saffron
salt to taste	salt
2 cubes  chicken bouillon	bouillon
1 1/2 cups uncooked white rice	rice
1 cup beer	beer
1 (15 ounce) can peas, drained	ounce
1/2 red bell pepper, roasted and sliced	bell
4 skinless, boneless chicken breast halves	halves
salt and pepper to taste	taste
2 teaspoons olive oil	oil
1 (14.5 ounce) can diced tomatoes with green peppers and onions	onions
1/4 cup sun-dried tomato pesto	None
1 (14 ounce) can artichoke hearts in water, drained and quartered	water
1 (15 ounce) can chickpeas (garbanzo beans), drained	beans
1 clove garlic	garlic
1/2 cup drained marinated artichoke hearts	hearts
2 tablespoons lemon juice	juice
2 tablespoons water	water
1 tablespoon chopped fresh parsley	parsley
Quaker® Quakes® Ranch or Sour Cream and Onion Flavor Rice Snacks	Snacks
3 cloves garlic, minced	cloves
2 tablespoons minced fresh ginger root	root
3/4 cup olive oil	oil
1/3 cup rice vinegar	vinegar
1/2 cup soy sauce	sauce
3 tablespoons honey	honey
1/4 cup water	water
1 egg white	None
1 tablespoon soy sauce	sauce
1/2 cup dry bread crumbs	crumbs
1 tablespoon finely chopped onion	onion
1 garlic clove, minced	clove
1/4 teaspoon ground ginger	ginger
1/8 teaspoon pepper	pepper
12 ounces ground turkey	turkey
1 (10 ounce) can asparagus tips, drained	ounce
1/2 cup mayonnaise	mayonnaise
2 tablespoons finely chopped onion	onion
1 pinch seasoning salt	salt
1 (1 pound) loaf soft, sliced white bread	pound
2 pounds lean ground beef	beef
1/2 large onion, diced	onion
1 tablespoon crushed red pepper	pepper
3 tablespoons garlic powder	tablespoons
1 tablespoon seasoned pepper	pepper
2 (4 ounce) cans mushroom pieces, drained	pieces
1 (28 ounce) can baked beans	ounce
2 (15.25 ounce) cans kidney beans with liquid	liquid
2 (6 ounce) cans tomato paste	ounce
1/4 cup white sugar	sugar
3 carrots, sliced	carrots
3 stalks celery, sliced	celery
1 green bell pepper, diced	pepper
1 red bell pepper, diced	pepper
2 jalapeno chile peppers, diced	peppers
1/4 cup Canadian beer	beer
2 tablespoons crushed red pepper	pepper
hot sauce	sauce
1/4 cup barbeque sauce	sauce
1 (8 ounce) package cream cheese, softened	cheese
1/2 cup butter, softened	butter
2 cups all-purpose flour	flour
1 cup white sugar	sugar
1/3 cup milk	milk
1/2 pound ground walnuts	walnuts
1/3 cup confectioners' sugar for decoration	decoration
1 large avocado, peeled and pitted	avocado
2 cloves garlic, minced	cloves
1 lemons, juiced	lemons
1/4 cup sour cream (optional)	cream
1/2 cup chopped seeded cucumber	cucumber
1/2 teaspoon red pepper flakes, or to taste	taste
1 tablespoon chopped fresh cilantro	cilantro
1 tablespoon chopped fresh mint	mint
salt and pepper to taste	taste
2 slices whole wheat bread, toasted (optional)	bread
1 tablespoon mayonnaise	mayonnaise
2 teaspoons Dijon-style prepared mustard	mustard
3 slices smoked turkey breast	breast
2 tablespoons guacamole	guacamole
1/2 cup mixed salad greens	greens
1/4 cup bean sprouts	sprouts
1/4 avocado - peeled, pitted and sliced	avocado
3 ounces Colby-Monterey Jack cheese, sliced	cheese
2 slices tomato	slices
1 1/2 cups dried black-eyed peas, soaked overnight	peas
1/3 cup chopped celery, with leaves	leaves
1 1/2 cups shredded carrot	carrot
3/4 cup chopped fresh parsley	parsley
1/2 cup chopped white onion	onion
1/8 cup chopped fresh mint	mint
1/4 cup olive oil	oil
2 oranges, juiced	oranges
1/2 lemon, juiced	None
1 garlic clove, pressed	clove
1/2 teaspoon ground coriander	coriander
1/2 teaspoon salt	salt
1/8 teaspoon freshly ground black pepper	pepper
1 teaspoon brown sugar	sugar
12 ounces chopped raw bacon	bacon
1 small white onion, chopped	onion
5 button mushrooms, chopped	mushrooms
1 1/2 pounds extra-lean ground beef	beef
1 egg	egg
1/4 cup evaporated milk	milk
6 ounces shredded Swiss cheese, divided	cheese
1/2 cup corn flake crumbs	crumbs
1/2 cup shredded Cheddar cheese	cheese
1 tablespoon grated Parmesan cheese	cheese
1 small onion, chopped	onion
1 egg	egg
1 tablespoon ketchup	ketchup
1 tablespoon Worcestershire sauce	sauce
1/2 teaspoon salt	salt
1/8 teaspoon pepper	pepper
1 pound ground beef	pound
6 slices bacon	bacon
6 hamburger buns, split	buns
10 hot dogs, cut into thirds	thirds
15 slices bacon, cut in half	half
1/2 cup packed brown sugar	sugar
1 pound sliced bacon, cut into thirds	thirds
1 (14 ounce) package beef cocktail wieners	wieners
3/4 cup brown sugar, or to taste	sugar
1 1/2 pounds russet potatoes	potatoes
1/2 cup all-purpose flour	flour
1 egg	egg
1 tablespoon chopped fresh parsley	parsley
1/2 teaspoon salt	salt
1/4 teaspoon freshly ground nutmeg	teaspoon
1/4 cup lard or other cooking fat	cooking
1 fluid ounce dark rum	rum
1/2 fluid ounce apricot brandy	brandy
3 1/2 fluid ounces fruit punch	punch
1/2 fluid ounce pina colada mix	mix
1/4 cup lemon juice	juice
1/4 cup light corn syrup	syrup
2 tablespoons soy sauce	sauce
1 teaspoon salt	salt
1/4 teaspoon ground ginger	ginger
1/4 cup corn oil	oil
1 (8 ounce) can crushed pineapple (not drained)	pineapple
10 chicken leg quarters	quarters
4 cups milk	milk
1/2 cup packed brown sugar	sugar
2 teaspoons butter or margarine	margarine
1/2 teaspoon salt	salt
1/2 teaspoon ground cinnamon	cinnamon
2 cups old-fashioned oats	oats
2 cups chopped, peeled apples	apples
1 cup chopped walnuts	walnuts
1 cup raisins	raisins
1 cup wheat germ	germ
1 1/2 cups Plain yogurt or sour cream	cream
1/4 cup lemon juice	juice
1/2 teaspoon Worcestershire sauce	sauce
1/2 teaspoon celery seed	seed
1/2 teaspoon Hungarian sweet paprika	paprika
1 garlic clove, minced	clove
1/2 teaspoon salt	salt
1/4 teaspoon pepper	pepper
8 skinless, boneless chicken breast halves	halves
2 cups fine dry bread crumbs	crumbs
3 pounds ground beef	beef
17 saltine crackers, finely crushed	crackers
1/2 cup milk	milk
1 1/2 teaspoons garlic powder	teaspoons
1 1/2 teaspoons onion powder	powder
1/4 teaspoon ground black pepper	pepper
1 pinch salt, or to taste	pinch
1/2 cup all-purpose flour	flour
1 tablespoon vegetable oil	oil
1 1/2 cups water	water
1 (10.75 ounce) can  condensed beef and mushroom soup	ounce
1 (.75 ounce) packet dry brown gravy mix	ounce
12 ounces dry fettuccine pasta	pasta
1 pound lean ground beef (optional)	beef
1 cup chopped onion	onion
1 cup red bell pepper, chopped	pepper
1 tablespoon butter	butter
1 (29 ounce) can diced tomatoes	tomatoes
1 (4 ounce) can sliced mushrooms	mushrooms
3 tablespoons chopped black olives	olives
2 teaspoons dried oregano	oregano
1 cup shredded Cheddar cheese	cheese
1 cup shredded mozzarella cheese	cheese
1 (10.75 ounce) can condensed cream of mushroom soup	soup
1/4 cup beef broth	broth
1/4 cup grated Parmesan cheese	cheese
1 1/2 cups boiling chicken broth	broth
1/2 cup uncooked long grain rice	rice
1/4 teaspoon Italian seasoning	seasoning
1/4 teaspoon garlic powder	powder
1 (10 ounce) package frozen chopped broccoli, thawed and drained	broccoli
1 tablespoon grated Parmesan cheese	cheese
1 (2.8 ounce) can French-fried onions, divided	ounce
1 pound fresh or frozen fish fillets, thawed	fillets
1 dash paprika	paprika
1/2 cup shredded Cheddar cheese	cheese
1 (1 pound) loaf French bread, cut diagonally in 1 inch slices	slices
8 eggs	eggs
2 cups milk	milk
1 1/2 cups half-and-half cream	cups
2 teaspoons vanilla extract	extract
1/4 teaspoon ground cinnamon	cinnamon
3/4 cup butter	cup
1 1/3 cups brown sugar	cups
3 tablespoons light corn syrup	syrup
1 teaspoon olive oil	oil
1 cup diced zucchini	zucchini
1/2 cup minced onion	onion
1 clove garlic, peeled and minced	clove
2 cups diced fresh tomatoes	tomatoes
2 tablespoons chopped fresh basil	basil
1/4 teaspoon salt	salt
1/4 teaspoon ground black pepper	pepper
4 (6 ounce) halibut steaks	ounce
1/3 cup crumbled feta cheese	cheese
6 center cut pork chops, trimmed of any visible fat	fat
1 teaspoon garlic powder	powder
1/2 teaspoon seasoning salt	salt
1 egg, beaten with	egg
1/4 cup egg substitute	substitute
1/4 cup all-purpose flour	flour
2 cups Italian-style seasoned bread crumbs	crumbs
2 tablespoons olive oil	oil
canola cooking spray	spray
1 (10.75 ounce) can  reduced fat condensed cream of mushroom soup	soup
1/2 cup 1% low-fat milk	%
1/3 cup white wine	wine
2 1/2 cups soft bread crumbs	cups
4 garlic cloves, minced	cloves
2 tablespoons grated Parmesan cheese	cheese
2 teaspoons dried parsley flakes	teaspoons
1 teaspoon dried thyme	thyme
1 teaspoon dried rosemary, crushed	teaspoon
1/2 teaspoon salt	salt
1/4 teaspoon pepper	pepper
2 tablespoons butter, melted	butter
1 (3 pound) salmon fillet	pound
1 spaghetti squash, halved lengthwise and seeded	lengthwise
1 onion, chopped	onion
2 tablespoons minced garlic	tablespoons
2 (14 ounce) cans stewed tomatoes	ounce
1 tablespoon dried basil	basil
1 cube vegetable bouillon	bouillon
black pepper to taste	taste
1 (15 ounce) can black olives, chopped	ounce
1 cup shredded mozzarella cheese	cheese
1 cup shredded Parmesan cheese	cheese
3/4 cup cake flour	flour
3/4 cup all-purpose flour	flour
1 teaspoon white sugar	sugar
1/2 teaspoon salt	salt
1/8 teaspoon baking powder	powder
4 tablespoons unsalted butter	butter
5 tablespoons shortening	shortening
1 egg yolk	yolk
2 teaspoons distilled white vinegar	vinegar
3 cubes  ice	ice
1/2 cup cold water	water
1/2 cup butter, softened	butter
1/2 cup brown sugar	sugar
3 bananas, mashed	bananas
1/4 cup milk	milk
1 teaspoon vanilla extract	extract
2 eggs	eggs
1 1/2 cups all-purpose flour	flour
1/2 cup wheat bran	wheat
1 teaspoon baking powder	powder
1 teaspoon baking soda	soda
1/4 teaspoon salt	salt
1/2 cup chopped walnuts	walnuts
1 3/4 cups all-purpose flour	flour
1/2 cup white sugar	sugar
1 tablespoon baking powder	powder
1/2 teaspoon salt	salt
1/2 cup semisweet chocolate chips	chips
1 egg	egg
1/4 cup vegetable oil	oil
1/4 cup milk	milk
1 cup mashed bananas	bananas
1/2 cup all-purpose flour	flour
1 tablespoon light brown sugar	sugar
1/4 teaspoon ground cinnamon	cinnamon
1/8 teaspoon salt	salt
2 tablespoons unsalted butter	butter
1 1/2 tablespoons ice water	water
1 cup skim milk	milk
3 egg whites	whites
2 tablespoons white sugar	sugar
1/4 teaspoon vanilla extract	extract
1 bananas, peeled and sliced	bananas
1 kiwi, peeled and sliced	kiwi
1 cup sliced fresh strawberries	strawberries
2 cups mashed ripe bananas	bananas
1 2/3 cups sugar	sugar
1 cup vegetable oil	oil
4 eggs	eggs
2 cups all-purpose flour	cups
2 teaspoons ground cinnamon	ground
2 teaspoons baking powder	powder
1 teaspoon baking soda	soda
1 teaspoon salt	salt
1/4 cup butter or margarine, softened	margarine
3 cups confectioners' sugar	sugar
1/4 cup orange juice	cup
1/2 teaspoon grated orange peel	peel
3 pounds beef roast	roast
2 onions, chopped	onions
2 (12 fluid ounce) cans or bottles beer	ounce
6 teaspoons Worcestershire sauce	sauce
2 teaspoons liquid smoke flavoring	teaspoons
2 teaspoons garlic powder	teaspoons
2 teaspoons ground black pepper	pepper
salt to taste	salt
1 (18 ounce) bottle barbecue sauce	ounce
2 cups water	water
1 pound chicken parts	parts
1 large onion	onion
3 stalks celery, including some leaves	leaves
1 large carrot	carrot
1 1/2 teaspoons salt	salt
3 whole cloves	cloves
6 cups water	water
1/4 cup cold water (optional)	water
1 egg	egg
1 cup white sugar	sugar
1 cup water	water
2 pandan leaves	leaves
1 1/4 pounds ground beef	beef
3 tablespoons Worcestershire sauce	sauce
1 1/2 tablespoons dried basil, or to taste	basil
1/4 teaspoon garlic salt	salt
1/4 teaspoon ground black pepper	pepper
4 hamburger buns, split	buns
1/2 cup teriyaki sauce	sauce
1 cup oyster sauce	sauce
1/4 cup soy sauce	sauce
1/4 cup ketchup	ketchup
2 tablespoons garlic powder	tablespoons
1/4 cup gin	gin
2 dashes liquid smoke flavoring	dashes
1/2 cup white sugar	sugar
1 1/2 pounds chicken wings, separated at joints, tips discarded	tips
1/4 cup honey	honey
1 (5 pound) chuck roast	pound
1 cup barbeque sauce	sauce
1 cup teriyaki sauce	sauce
1 (12 fluid ounce) can or bottle beer	beer
3 teaspoons minced garlic	garlic
3 teaspoons thinly sliced fresh ginger root	root
1 onion, finely chopped	onion
3 teaspoons coarsely ground black pepper	pepper
2 teaspoons salt	salt
8 medium beets	beets
1 pound unsalted butter	butter
1 1/2 cups minced Vidalia onions	onions
4 Bosc pears - peeled, cored and minced	pears
2 tablespoons white sugar	sugar
1/2 cup cranberry vinegar	vinegar
1 teaspoon salt	salt
1 cup butter	butter
1 cup vegetable oil	oil
1 cup white sugar	sugar
1 cup packed brown sugar	sugar
2 eggs	eggs
1 teaspoon vanilla extract	extract
4 1/2 cups all-purpose flour	flour
2 teaspoons baking soda	soda
4 teaspoons cream of tartar	tartar
1 teaspoon salt	salt
2 cups semisweet chocolate chips	chips
1 cup chopped walnuts (optional)	walnuts
2 eggs	eggs
1 (12 ounce) can white tuna	tuna
1 (6 ounce) can crabmeat, shredded	ounce
1/2 cup mayonnaise	mayonnaise
1 teaspoon sour cream	teaspoon
1 teaspoon yellow mustard	mustard
1/2 teaspoon dried dill weed	weed
1/8 teaspoon lemon pepper	pepper
2 tablespoons dill pickle relish	tablespoons
2 tablespoons sweet pickle relish	pickle
3/4 cup finely chopped onion	onion
1 (16 ounce) package macaroni	macaroni
1/2 cup mayonnaise	mayonnaise
1 cup cucumber - peeled, seeded and chopped	cucumber
1 tablespoon dried minced onion	onion
1 cup diced ham	ham
1 cup shredded Cheddar cheese	cheese
3 tablespoons olive oil	oil
3 tablespoons white wine vinegar	vinegar
salt and pepper to taste	taste
1/2 cup butter, softened	butter
1/2 cup butter flavored shortening	shortening
1 cup packed light brown sugar	sugar
1/2 cup white sugar	sugar
2 eggs	eggs
1 teaspoon vanilla extract	extract
1 1/2 cups all-purpose flour	flour
1 teaspoon baking soda	soda
1 teaspoon ground cinnamon	cinnamon
1/2 teaspoon ground cloves	cloves
1/2 teaspoon salt	salt
3 cups rolled oats	oats
1 cup raisins	raisins
3/4 teaspoon active dry yeast	yeast
1/2 cup warm water	water
3 1/2 cups unbleached bread flour	flour
1 1/4 cups cold water	water
2 1/2 tablespoons olive oil	oil
3 tablespoons plain yogurt	yogurt
2 tablespoons distilled white vinegar	vinegar
1 medium onion, sliced	onion
2 cloves garlic, crushed	cloves
1 tablespoon ginger paste	paste
2 small green chile peppers	peppers
2 medium tomatoes, chopped	tomatoes
2 tablespoons garam masala	masala
1 tablespoon dried mint	mint
salt and pepper to taste	taste
5 sprigs cilantro	cilantro
1 (3 pound) whole chicken, skin removed and cut into pieces	pieces
2 quarts water	water
4 cups uncooked basmati rice	rice
1 bay leaf	leaf
4 pods green cardamom	cardamom
1 pod black cardamom	cardamom
1 cinnamon stick	stick
salt to taste	salt
1/4 teaspoon powdered yellow food coloring	coloring
2 teaspoons olive oil	oil
3 tablespoons finely chopped onion	onion
1 (15.5 ounce) can black beans, drained and rinsed	ounce
1 (10 ounce) can whole kernel corn, drained	ounce
1 tablespoon brown sugar	sugar
1/4 cup salsa	cup
1/4 teaspoon red pepper flakes	flakes
2 tablespoons butter, divided	butter
8 (8 inch) flour tortillas	inch
1 1/2 cups shredded Monterey Jack cheese, divided	cheese
1 tablespoon olive oil	oil
1 onion, chopped	onion
2 red bell pepper, seeded and chopped	pepper
1 jalapeno pepper, seeded and minced	pepper
10 fresh mushrooms, quartered	mushrooms
6 roma (plum) tomatoes, diced	tomatoes
1 cup fresh corn kernels	kernels
1 teaspoon ground black pepper	pepper
1 teaspoon ground cumin	cumin
1 tablespoon chili powder	powder
2 (15 ounce) cans black beans, drained and rinsed	ounce
1 1/2 cups chicken broth	broth
1 teaspoon salt	salt
8 lasagna noodles, uncooked	noodles
1 cup shredded reduced-fat Monterey Jack cheese	cheese
1 (15 ounce) container part-skim ricotta cheese	ounce
1 (4.5 ounce) can chopped green chiles, drained	chiles
1/2 teaspoon chili powder	powder
1/8 teaspoon salt	salt
2 cups drained canned no-salt-added black beans	cups
Cooking spray	spray
1 (15.5 ounce) jar no-salt-added salsa	ounce
Fresh cilantro sprigs (optional)	sprigs
1 (21 ounce) can cherry pie filling	ounce
1 (16.5 ounce) can pitted dark sweet cherries	cherries
1 (18.25 ounce) package chocolate cake mix	mix
1 cup chopped walnuts	walnuts
3/4 cup butter, cut into pieces	pieces
1 1/2 pounds fresh tuna steaks, 1 inch thick	inch
2 tablespoons Cajun seasoning	seasoning
2 tablespoons olive oil	oil
2 tablespoons butter	butter
1 pound bocconcini (bite-size mozzarella balls)	balls
8 cherry tomatoes, halved	tomatoes
1/2 cup chopped green bell pepper	pepper
1/2 cup chopped celery	celery
1/2 cup Belgian endive leaves	leaves
1/2 cup coarsely chopped arugula, stems included	arugula
1 1/2 tablespoons fresh lemon juice	juice
3 tablespoons extra virgin olive oil	oil
salt and pepper to taste	taste
2 tablespoons chopped fresh basil leaves	tablespoons
3 tablespoons crushed black peppercorns	peppercorns
2 (8 ounce) beef top sirloin steaks	ounce
1 tablespoon lemon pepper	pepper
1 teaspoon salt	salt
5 tablespoons butter	butter
2 cloves garlic, minced	cloves
1/2 cup red wine	wine
3 tablespoons brandy	brandy
1/4 cup chopped green onions	onions
1 shallot, chopped	shallot
1/2 cup heavy cream	cream
1 teaspoon white sugar (optional)	sugar
6 1/4 cups cubed whole wheat bread	bread
1 1/4 cups milk	milk
1 egg, beaten	egg
1/3 cup butter, softened	butter
3/4 cup raisins	raisins
1/4 cup dried mixed fruit	fruit
1/2 cup brown sugar	sugar
1 tablespoon ground nutmeg	nutmeg
1 tablespoon ground cinnamon	cinnamon
1 tablespoon butter, unsalted	butter
2 cups Broccoflower™, diced	Broccoflower&
2 cups assorted wild mushrooms, chopped	mushrooms
1/2 white onion, chopped	onion
2 tablespoons garlic, minced	tablespoons
3 cups Arborio rice	rice
9 cups chicken stock, unsalted	stock
1 pinch fresh ground nutmeg	nutmeg
1/4 cup fresh herbs; tarragon, parsley, chives, diced	parsley
1/4 cup Parmesan cheese	cheese
Salt and pepper to taste	taste
2 eggs	eggs
1/4 cup water	cup
6 tablespoons all-purpose flour	flour
1/2 teaspoon salt	salt
2 tablespoons chopped onion	onion
1 tablespoon butter	butter
1 tablespoon all-purpose flour	flour
1 cup milk	None
1 cup shredded Cheddar cheese, divided	cheese
1 1/2 teaspoons Dijon mustard	mustard
1 teaspoon Worcestershire sauce	sauce
1/4 teaspoon pepper	pepper
1/8 teaspoon salt	1/8
2 cups frozen chopped broccoli, thawed	broccoli
2 cups chopped, cooked chicken meat	meat
2 cups fresh chopped broccoli	broccoli
1/2 cup chopped onion	onion
1/2 cup chopped green bell pepper	pepper
1 1/2 cups shredded Cheddar cheese	cheese
1/2 cup mayonnaise	mayonnaise
2 tablespoons Dijon-style prepared mustard	mustard
salt and pepper to taste	taste
1 tablespoon minced garlic	garlic
1 (8 ounce) package refrigerated crescent rolls	rolls
1 cup olive oil	oil
1/3 cup distilled white vinegar	vinegar
1/2 cup white sugar	sugar
1 (3 ounce) package chicken flavored ramen noodles, crushed, seasoning packet reserved	packet
1 large head fresh broccoli, diced	head
2 carrots, grated	carrots
2 bunches green onions, chopped	onions
1 cup sunflower seeds	seeds
1/4 cup olive oil	oil
8 cloves garlic, minced	cloves
2 1/2 teaspoons salt	salt
1 teaspoon pepper	pepper
2 tablespoons ground cumin	cumin
1 tablespoon dried oregano	oregano
1 (8 pound) leg of lamb, boned and butterflied to a more or less even thickness, 4 3/4 to 5 1/2 pounds trimmed weight, fell and most fat removed	None
1 lemon, juiced	lemon
Minced fresh parsley, cilantro or mint  (optional)	mint
1 medium head garlic	garlic
1 tablespoon olive oil	oil
4 skinless, boneless chicken breasts	breasts
1/2 cup white wine	wine
2 tablespoons butter	butter
1 cup milk	milk
1 tablespoon all-purpose flour	flour
1/4 cup grated Parmesan cheese	cheese
1 tablespoon chopped fresh parsley	parsley
3 hard-cooked eggs, chopped	eggs
1/4 cup crushed saltine crackers	crackers
1/4 cup chopped celery	celery
1 tablespoon diced pimientos	pimientos
1/2 cup mayonnaise	mayonnaise
2 tablespoons milk	milk
1/8 teaspoon salt	salt
1/8 teaspoon garlic salt	salt
1/8 teaspoon pepper	pepper
2 English muffins, split and toasted	muffins
1/2 cup flaked coconut	coconut
1/2 cup white sugar	sugar
2 cups packed brown sugar	sugar
2 cups all-purpose flour	flour
1 1/2 teaspoons baking powder	powder
1/4 teaspoon salt	salt
2. Add: 3/4 cup butter or margarine, softened at room temperature. 	None
Mix in 2 eggs, slightly beaten and 2 teaspoons vanilla.	None
Mix in 2 eggs, slightly beaten and 2 teaspoons vanilla.	None
10 slices Italian bread	bread
2 1/2 teaspoons olive oil	oil
4 vine-ripened tomatoes	tomatoes
1 teaspoon chopped fresh basil	basil
2 teaspoons olive oil	oil
4 boneless, skinless chicken breast halves	halves
1 (10 ounce) can refrigerated large crescent roll dough	dough
8 ounces Brie cheese	cheese
1 bunch fresh spinach, rinsed and stems removed	spinach
4 (1/2 ounce) slices prosciutto	ounce
24 chicken wings	wings
2 quarts vegetable oil for deep frying	frying
4 tablespoons butter	butter
1 tablespoon distilled white vinegar	vinegar
5 tablespoons hot pepper sauce	sauce
salt and pepper to taste	taste
1 pint vanilla ice cream	cream
1 cup buttermilk	buttermilk
1 teaspoon grated lemon peel	peel
1/2 teaspoon vanilla extract	extract
1 drop lemon extract	extract
1 cup butterscotch chips	chips
1 cup butter (no substitutes), softened	substitutes
1/2 cup sugar	sugar
1/2 cup packed brown sugar	sugar
1 egg	egg
2 tablespoons milk	milk
2 teaspoons vanilla extract	extract
3 cups all-purpose flour	flour
3/4 cup shortening	shortening
1/4 cup water	water
2 tablespoons all-purpose flour	flour
1 1/2 teaspoons vanilla extract	extract
4 cups confectioners' sugar	sugar
Paste food coloring	coloring
2 cups all-purpose flour	flour
1 1/2 tablespoons baking powder	powder
1/4 teaspoon salt	salt
1/2 cup flaked coconut	coconut
3/4 cup chopped pecans	pecans
2 cups packed brown sugar	sugar
Add 3/4 cup softened butter, 2 beaten eggs, and 2 teaspoons of vanilla extract; mix until well blended. 	None
Add 3/4 cup softened butter, 2 beaten eggs, and 2 teaspoons of vanilla extract; mix until well blended. 	None
Add 3/4 cup softened butter, 2 beaten eggs, and 2 teaspoons of vanilla extract; mix until well blended. 	None
8 cups shredded cabbage	cabbage
3 medium potatoes, cut into 1/2 inch cubes	cubes
1 medium onion, chopped	onion
1 3/4 teaspoons salt	salt
1/4 teaspoon pepper	pepper
1 (14.5 ounce) can chicken broth	ounce
2 pounds fully cooked kielbasa or Polish sausage, cut into serving size pieces	pieces
12 leaves cabbage	cabbage
1 cup cooked white rice	rice
1 egg, beaten	egg
1/4 cup milk	milk
1/4 cup minced onion	onion
1 pound extra-lean ground beef	beef
1 1/4 teaspoons salt	salt
1 1/4 teaspoons ground black pepper	pepper
1 (8 ounce) can tomato sauce	ounce
1 tablespoon brown sugar	sugar
1 tablespoon lemon juice	juice
1 teaspoon Worcestershire sauce	sauce
12 medium potatoes - peeled, cooked and cubed	potatoes
3 cups cubed fully cooked ham	ham
1/2 cup chopped onion	onion
1/2 cup butter or margarine	margarine
1 (10 ounce) package frozen chopped broccoli, thawed	broccoli
salt and pepper to taste	taste
Sour cream	cream
2 1/2 cups all-purpose flour	flour
1/2 cup white sugar	sugar
1 tablespoon baking powder	powder
1/2 teaspoon salt	salt
1 teaspoon ground cinnamon	cinnamon
1/4 teaspoon ground nutmeg	nutmeg
1 cup milk	milk
1 egg, beaten	egg
1/4 cup butter, melted and cooled	butter
2 teaspoons vanilla extract	extract
2 quarts oil for deep frying	frying
1/2 teaspoon ground cinnamon	cinnamon
1/2 cup white sugar	sugar
4 skinless, boneless chicken breasts	breasts
1 teaspoon olive oil	oil
1/2 teaspoon onion powder	powder
1 pinch salt	salt
1 pinch ground black pepper	pepper
2 avocados - peeled, pitted and sliced	avocados
2 ripe tomatoes, sliced	tomatoes
1 (8 ounce) package Monterey Jack cheese, cut into 10 slices	slices
2 cloves garlic, minced	cloves
1/2 cup goat cheese	cheese
1 celery stalk, minced	stalk
2 tablespoons balsamic vinegar	vinegar
1/2 cup olive oil	oil
salt and pepper to taste	taste
1 (10 inch) angel food cake, cut into large cubes	cubes
1 (5 ounce) can sweetened condensed milk	milk
1 cup coconut flakes	flakes
24x8x1 inch untreated cedar plank	plank
6 (4 ounce) fillets salmon	ounce
1/2 cup extra virgin olive oil	oil
1 large red onion, chopped	onion
1 lemon, sliced	lemon
1/2 tablespoon black peppercorns, crushed	peppercorns
Submerge untreated cedar plank in water. 	None
1 cup butter, softened	butter
1 cup white sugar	sugar
1/2 cup packed brown sugar	sugar
2 eggs	eggs
3 cups all-purpose flour	cups
1 teaspoon baking soda	soda
1 teaspoon salt	salt
6 (2.1 ounce) bars chocolate-coated peanut and nougat candy, eg: Baby	Baby
1 cup shortening	shortening
1 cup packed brown sugar	sugar
1/2 cup white sugar	sugar
2 eggs	eggs
2 teaspoons vanilla extract	extract
2 1/4 cups all-purpose flour	flour
1 teaspoon baking soda	soda
1 teaspoon salt	salt
1 1/2 cups candy-coated milk chocolate pieces	pieces
16 cups popped popcorn	popcorn
1 cup roasted peanuts	peanuts
1 cup brown sugar	sugar
1/2 cup butter	butter
1/4 cup light corn syrup	syrup
1 teaspoon vanilla extract	extract
1 teaspoon salt	salt
1/2 teaspoon baking soda	soda
1 cup milk chocolate chips	chips
1 teaspoon shortening	shortening
2/3 cup butter, softened	butter
1/4 cup white sugar	sugar
1 1/4 cups all-purpose flour	flour
1/2 cup butter	butter
1/2 cup packed light brown sugar	sugar
2 tablespoons light corn syrup	syrup
1/2 cup sweetened condensed milk	milk
1 1/4 cups milk chocolate chips	chips
6 individually wrapped caramels, unwrapped and chopped	caramels
2 tablespoons light corn syrup	syrup
2 apples - peeled, cored and diced	apples
1 cup rye flour	flour
3/4 cup all-purpose flour	flour
1/4 cup sugar	sugar
2 1/2 teaspoons baking powder	powder
1/2 teaspoon salt	salt
1/2 teaspoon caraway seeds	seeds
3/4 cup shredded Cheddar cheese	cheese
1 egg, beaten	egg
3/4 cup milk	milk
1/3 cup vegetable oil	oil
1/2 cup ketchup	ketchup
4 tablespoons unsweetened pineapple juice	juice
4 tablespoons molasses	molasses
2 tablespoons dark rum	rum
2 tablespoons prepared Dijon-style mustard	mustard
2 cloves garlic, chopped	cloves
salt and pepper to taste	taste
8 chicken thighs	thighs
4 large carrots, cut into 1 inch pieces	pieces
1/4 large onion, chopped	onion
1 quart vegetable broth	broth
1/2 cup chopped fresh cilantro	cilantro
2 cups all-purpose flour	flour
2 teaspoons baking soda	soda
1 teaspoon baking powder	powder
1 teaspoon salt	salt
2 teaspoons ground cinnamon	cinnamon
1 3/4 cups white sugar	sugar
1 cup vegetable oil	oil
3 eggs	eggs
1 teaspoon vanilla extract	extract
2 cups shredded carrots	carrots
1 cup flaked coconut	coconut
1 cup chopped walnuts	walnuts
1 (8 ounce) can crushed pineapple, drained	pineapple
1 (8 ounce) package cream cheese	cheese
1/4 cup butter, softened	butter
2 cups confectioners' sugar	confectioners
1 (16 ounce) package baby carrots, sliced	carrots
2 medium onions, sliced	onions
1 cup shredded Cheddar cheese	cheese
3 tablespoons butter	butter
3 tablespoons all-purpose flour	flour
1 1/2 cups milk	milk
1/2 teaspoon salt	salt
1/8 teaspoon ground black pepper	pepper
1 tablespoon butter	butter
1 cup fine dry bread crumbs	crumbs
2 quarts water	water
12 ounces beef shank	shank
2 large onions, chopped	onions
2 large carrots, sliced	carrots
1 rutabaga, diced	rutabaga
salt and pepper to taste	taste
4 potatoes, peeled and quartered	potatoes
2 leeks, sliced	leeks
1 small head cabbage, sliced	head
2 tablespoons chopped fresh parsley	parsley
1 cup unsalted butter	butter
1 cup chai tea mix	mix
1 1/3 cups white sugar	sugar
2 eggs	eggs
3 1/2 cups all-purpose flour	flour
1 tablespoon baking powder	powder
2 teaspoons salt	salt
1/2 cup white sugar for decoration	decoration
1 (7.5 ounce) jar marinated artichoke hearts	ounce
1 small onion, finely chopped	onion
1 garlic clove, minced	clove
4 eggs, beaten	eggs
1/4 cup dry bread crumbs	crumbs
1/4 teaspoon ground mustard	mustard
1/8 teaspoon dried oregano	oregano
1/8 teaspoon pepper	pepper
1/8 teaspoon hot pepper sauce	sauce
2 (8 ounce) packages shredded Cheddar cheese	cheese
2 tablespoons minced fresh parsley	parsley
4 medium baked potatoes, quartered lengthwise	lengthwise
1/3 cup Hidden Valley® Original Ranch® Salad Dressing	Salad
1 cup shredded Cheddar cheese	cheese
Sliced green onions (optional)	onions
Bacon pieces (optional)	pieces
6 Yukon Gold potatoes, peeled and cubed	potatoes
2 sweet potatoes, peeled and cubed	potatoes
2 tablespoons butter	butter
1/2 cup heavy cream	cream
1 tablespoon chicken bouillon granules	granules
1 2/3 tablespoons brown sugar	sugar
2 teaspoons black pepper	pepper
2 cups shredded Monterey Jack cheese	cheese
2 tablespoons cooking oil	oil
3 large skinless, boneless chicken breast halves - cut into 1 inch pieces	pieces
sea salt to taste	taste
1 tablespoon chili powder, or to taste	powder
1/2 tablespoon ground cumin, or to taste	ground
1 dried chipotle chili pepper, ground into powder	powder
ground black pepper to taste	taste
1/2 teaspoon ground cayenne pepper	pepper
1 small yellow onion, diced	onion
1 medium green bell pepper, diced	pepper
1 medium yellow bell pepper, diced	pepper
5 cups water	water
1 (15 ounce) can kidney beans, undrained	ounce
1 (15 ounce) can black beans, undrained	ounce
1 (11 ounce) can whole kernel corn, drained	ounce
1 teaspoon green pepper sauce (e.g., Tabasco®)	Tabasco&
1 (6 ounce) can roasted garlic tomato paste	ounce
1 bunch fresh cilantro, chopped	cilantro
2 tablespoons olive oil	oil
1 (4 pound) chicken, cut into pieces	pieces
garlic powder to taste	taste
1/2 pound fresh mushrooms, sliced	mushrooms
1 large onion, diced	onion
1/2 teaspoon dried basil	basil
1/2 teaspoon dried oregano	oregano
1/2 teaspoon dried rosemary	rosemary
1/2 teaspoon dried thyme	thyme
1 teaspoon garlic salt	salt
1/4 teaspoon black pepper	pepper
1 teaspoon poultry seasoning	seasoning
1 cup dry white wine	wine
1 (10.5 ounce) can chicken broth	ounce
1 (6 ounce) package herb-seasoned dry bread stuffing mix	mix
8 skinless, boneless chicken breast halves	halves
16 medium slices mozzarella cheese	cheese
2 skinless, boneless chicken breast halves	halves
1 (1.27 ounce) packet dry fajita seasoning, divided	seasoning
1 tablespoon vegetable oil	oil
1 (15 ounce) can black beans, rinsed and drained	ounce
1 (11 ounce) can Mexican-style corn	ounce
1/2 cup salsa	cup
1 (10 ounce) package mixed salad greens	ounce
1 onion, chopped	onion
1 tomato, cut into wedges	wedges
1/2 cup all-purpose flour	flour
2 teaspoons salt	salt
1 1/2 teaspoons ground mustard	mustard
1/2 teaspoon garlic powder	powder
6 pork loin chops (3/4 inch thick), trimmed	inch
2 tablespoons vegetable oil	oil
1 (10.75 ounce) can condensed cream of chicken soup, undiluted	soup
1/3 cup water	water
3/4 cup butter, divided	butter
2 tablespoons vegetable oil, divided	oil
4 portobello mushroom caps, sliced	caps
1 clove garlic, chopped	garlic
3/4 cup all-purpose flour, divided	flour
1 (14.5 ounce) can beef broth	broth
1/2 cup dry Marsala wine	wine
kosher salt and ground black pepper to taste	taste
1 tablespoon browning sauce	sauce
6 skinless, boneless chicken breast halves - pounded to 1/2 inch thickness	thickness
3 bone-in chicken breast halves, skinless	halves
1 (14.5 ounce) can chicken broth	ounce
3 potatoes	potatoes
1 yellow onion	onion
3 stalks celery	stalks
2 tablespoons vegetable oil	oil
2 tablespoons all-purpose flour	flour
2 cups frozen mixed vegetables	vegetables
1 to taste salt and pepper to taste	taste
1/4 teaspoon garlic powder	powder
1 (9 inch) frozen prepared pie crust, thawed	crust
1 1/2 pounds skinless, boneless chicken breast meat	meat
1 cup chicken broth	broth
1/2 teaspoon salt	salt
1/4 teaspoon ground black pepper	pepper
1 1/2 cups milk	milk
3 tablespoons butter	butter
1 onion, chopped	onion
1 cup chopped celery	celery
1/3 cup all-purpose flour	flour
2 cups frozen mixed vegetables, thawed	vegetables
1 tablespoon chopped fresh parsley	parsley
1/2 teaspoon dried thyme	thyme
1 (9 inch) pastry for a 9 inch single crust pie	pie
1 egg, lightly beaten	egg
1 pound skinless, boneless chicken breast halves - cubed	halves
1 cup sliced carrots	carrots
1 cup frozen green peas	peas
1/2 cup sliced celery	celery
1/3 cup butter	butter
1/3 cup chopped onion	onion
1/3 cup all-purpose flour	flour
1/2 teaspoon salt	salt
1/4 teaspoon black pepper	pepper
1/4 teaspoon celery seed	seed
1 3/4 cups chicken broth	broth
2/3 cup milk	milk
2 (9 inch)  unbaked pie crusts	inch
4 cups rotisserie chicken, skinned and boned, meat shredded into bite-sized pieces	pieces
2 medium celery ribs, cut into small dice	dice
2 medium green onions, sliced thin	onions
1/4 cup chopped honey-roasted peanuts	peanuts
2 tablespoons lime juice	juice
2 tablespoons Asian fish sauce	sauce
1 teaspoon ground ginger	ginger
2 teaspoons white sugar	sugar
1/2 teaspoon hot red pepper flakes	flakes
2 tablespoons minced fresh cilantro leaves	leaves
2 tablespoons chopped fresh mint leaves	leaves
Boston lettuce	lettuce
sliced cucumbers	cucumbers
grated carrots	carrots
chopped honey-roasted peanuts	peanuts
3 (10 ounce) packages frozen chopped spinach, thawed	ounce
3 eggs	eggs
1/2 teaspoon onion salt	salt
1/2 teaspoon ground nutmeg	nutmeg
3/4 cup grated Parmesan cheese, divided	cheese
3/4 cup Italian seasoned bread crumbs	crumbs
16 skinless, boneless chicken breast halves	halves
salt and pepper to taste	taste
5 tablespoons butter or margarine, melted	margarine
6 tablespoons butter or margarine, divided	margarine
1/4 cup all-purpose flour	cup
1/2 teaspoon salt	salt
2 cups milk	milk
2 cups shredded Cheddar cheese	cheese
1 cup sliced fresh mushrooms	mushrooms
6 large sourdough buns	buns
2 cups boneless chicken breast halves, cooked and diced	halves
1 (8 ounce) package cream cheese, softened	cheese
1 cup shredded Pepper Jack cheese	cheese
1 cup grated Parmesan cheese	cheese
6 cloves garlic, pressed	cloves
1 (10 ounce) package frozen chopped spinach, thawed and drained	spinach
1 pound skinless, boneless chicken breast halves, cut into bite size pieces	pieces
1 cup lemonade	lemonade
2 tablespoons olive oil	oil
1 tablespoon lime juice	juice
1 1/2 teaspoons Worcestershire sauce	sauce
1/2 teaspoon garlic powder	powder
1/2 teaspoon onion powder	powder
1 bay leaf	leaf
1 (12 ounce) package corn tortillas	tortillas
1 head lettuce, shredded	lettuce
2 large tomatoes, chopped	tomatoes
1 (8 ounce) package shredded sharp Cheddar cheese	cheese
1 (8 ounce) jar salsa	ounce
1 (8 ounce) container sour cream	ounce
1 recipe Fast Chicken Soup Base	Base
1 (9 ounce) package refrigerated small cheese tortellini	tortellini
1 (14.5 ounce) can diced tomatoes	tomatoes
2 medium zucchini, diced	zucchini
1 teaspoon dried basil	basil
1/2 cup chopped fresh parsley	parsley
Salt and freshly ground black pepper	pepper
2 1/2 teaspoons vegetable oil	oil
6 (6 inch) corn tortillas, cut into 1/2 inch strips	strips
3 cups chicken broth	broth
1/2 teaspoon ground cumin	cumin
1/2 teaspoon chili powder	powder
1/2 teaspoon dried oregano	oregano
1 (15 ounce) can black beans, rinsed and drained	ounce
1 (15 ounce) can whole kernel corn, drained	ounce
2 skinless, boneless chicken breast halves, cut into bite size pieces	pieces
1/2 cup salsa	cup
1/2 cup chopped fresh cilantro	cilantro
4 skinless, boneless chicken breast halves, cut into bite size pieces	pieces
1 onion, chopped	onion
1/2 pound baby carrots	carrots
4 potatoes	potatoes
1/2 teaspoon salt	salt
1/4 teaspoon ground turmeric	turmeric
3 tablespoons tomato paste	paste
1/2 cup water	cup
1/4 teaspoon garlic powder (optional)	powder
1/2 teaspoon ground black pepper (optional)	pepper
1 cup sliced fresh mushrooms	mushrooms
4 chicken drumsticks, skin removed	skin
4 chicken thighs, skin removed	skin
4 celery ribs, sliced	ribs
1 cup sliced zucchini	zucchini
1 cup sliced carrots	carrots
1 medium onion, sliced	onion
1 cup tomato juice	juice
1/2 cup chicken broth	broth
1 garlic clove, minced	clove
1/4 teaspoon paprika	None
pepper to taste	taste
3 tablespoons cornstarch	cornstarch
3 tablespoons cold water	water
Hot cooked rice	rice
1/4 pound ground beef	beef
1/4 cup chopped onion	onion
1 garlic clove, minced	clove
1 (15.5 ounce) can chili beans, undrained	ounce
1 (14.5 ounce) can diced tomatoes, undrained	tomatoes
1 1/2 teaspoons chili powder	teaspoons
1/2 teaspoon ground cumin	cumin
1 cup light mayonnaise	mayonnaise
2 tablespoons canned Chipotle peppers in adobo sauce, seeded and minced	sauce
1/4 cup chopped green onion	onion
1/4 cup sweet pickle relish	relish
1 1/2 cups chocolate cookie crumbs	crumbs
2 tablespoons white sugar	sugar
1/4 cup butter, melted	butter
1/4 cup semisweet chocolate chips	chips
1/4 cup heavy whipping cream	cream
3 (8 ounce) packages cream cheese, softened	ounce
1 cup white sugar	sugar
1/3 cup unsweetened cocoa powder	powder
3 eggs	eggs
1 teaspoon vanilla extract	extract
1 1/2 cups semisweet chocolate chips	semisweet
1/4 cup heavy whipping cream	cream
1 teaspoon vanilla extract	extract
1 cup semisweet chocolate chips	chips
1/2 cup butter, softened	butter
1/2 cup white sugar	sugar
1/2 cup packed brown sugar	sugar
2 eggs	eggs
1/2 teaspoon vanilla extract	extract
2 cups all-purpose flour	cups
1/2 teaspoon baking powder	powder
1/2 teaspoon baking soda	soda
1 (18 ounce) package small chocolate chip cookies	ounce
1/4 cup margarine, melted	margarine
1 cup hot fudge topping	cup
2 quarts vanilla ice cream	cream
1 cup whipped cream	cream
12 cherries	cherries
3 cups crushed vanilla wafers	wafers
1/2 cup chopped pecans	pecans
2/3 cup butter, melted	butter
2 cups semisweet chocolate chips	chips
4 cups milk	milk
4 1/2 cups miniature marshmallows	marshmallows
2 (3.5 ounce) packages instant vanilla pudding mix	ounce
1 cup frozen whipped topping, thawed	cup
2 large bananas, sliced	bananas
1 (1.5 ounce) bar milk chocolate candy	ounce
2 (10 ounce) packages pretzels	ounce
1 tablespoon heavy whipping cream	cream
2 cups semisweet chocolate chips	chips
1/4 cup cold margarine	margarine
1 cup all-purpose flour	flour
1 (8 ounce) package light cream cheese, softened	cheese
2 tablespoons heat-stable granular sugar substitute	substitute
1 (8 ounce) container reduced-fat frozen whipped topping, thawed, divided	ounce
1 1/2 cups cold skim milk	milk
1 (1.4 ounce) package instant  sugar-free chocolate pudding mix	mix
1 tablespoon butter, softened	butter
1 egg white	None
1/4 cup white sugar	sugar
1 teaspoon vanilla extract	extract
2 1/2 tablespoons all-purpose flour	flour
1 tablespoon unsweetened cocoa powder	powder
1 pinch salt	salt
1/2 (1 ounce) square unsweetened chocolate, grated	ounce
1/3 cup confectioners' sugar for decoration	decoration
1 cup chocolate hazelnut spread	spread
4 crepes	crepes
4 bananas, sliced	bananas
1 (7 ounce) can pressurized whipped cream	cream
1/4 cup sifted all-purpose flour	flour
1/4 cup unsweetened cocoa powder	powder
1/2 teaspoon baking powder	powder
1 pinch salt	salt
2 ounces butter	butter
1/2 teaspoon vanilla extract	extract
1/4 cup white sugar	sugar
1 egg	egg
2 egg yolks	yolks
1/3 cup confectioners' sugar for decoration	decoration
2 tablespoons olive oil	oil
3 garlic cloves, minced	cloves
2 (14.5 ounce) cans petite diced tomatoes	ounce
1/4 cup tomato paste	cup
1/2 teaspoon dried basil	basil
1/4 teaspoon dried oregano	oregano
1 cup water	water
2 1/2 tablespoons white sugar	sugar
1/2 teaspoon salt	salt
2 tablespoons vegetable oil	oil
1 cup all-purpose flour	flour
2 quarts oil for frying	frying
1/2 cup white sugar, or to taste	sugar
1 teaspoon ground cinnamon	cinnamon
1 pound ground pork	pork
4 cups shredded cabbage	cabbage
1 large carrot, shredded	carrot
1/2 green bell pepper, cut into thin strips	strips
1 medium onion, chopped	onion
3 cloves garlic, minced	cloves
3 teaspoons fresh ginger root, grated	root
1 tablespoon cornstarch	cornstarch
2 tablespoons soy sauce	sauce
1 1/2 tablespoons molasses	molasses
2 tablespoons vegetable oil	oil
1 quart oil for frying	frying
1 1/2 (14 ounce) packages egg roll wrappers	ounce
1 1/2 cups sweet and sour sauce	sauce
2 cups all-purpose flour	flour
1 cup white sugar	sugar
2 teaspoons baking powder	powder
1/2 teaspoon baking soda	soda
1 1/2 teaspoons ground cinnamon	cinnamon
1 teaspoon salt	salt
1 cup buttermilk	buttermilk
1/4 cup vegetable oil	oil
2 eggs	eggs
2 teaspoons vanilla extract	extract
2 tablespoons white sugar	sugar
1 teaspoon ground cinnamon	cinnamon
2 teaspoons margarine	teaspoons
2 cups all-purpose flour	flour
2 cups sugar	sugar
1 1/2 teaspoons ground cinnamon	cinnamon
1/4 teaspoon salt	salt
1 cup water	water
1/2 cup vegetable oil	oil
1/2 cup butter or margarine	margarine
1/4 cup baking cocoa	cocoa
2 eggs	eggs
1/2 cup buttermilk	cup
1 teaspoon vanilla extract	extract
1 teaspoon baking soda	soda
1/2 cup butter or margarine	margarine
1/3 cup whipping cream	cream
1/4 cup baking cocoa	cocoa
1 1/2 teaspoons ground cinnamon	cinnamon
3 cups confectioners' sugar	sugar
1 teaspoon vanilla extract	extract
1 cup finely chopped walnuts	walnuts
1/2 cup butter, softened	butter
1/2 cup shortening	shortening
1 cup sugar	sugar
1/2 cup packed brown sugar	sugar
1 egg	egg
1 teaspoon vanilla extract	extract
1/2 teaspoon almond extract	extract
2 1/2 cups all-purpose flour	flour
1 tablespoon ground cinnamon	ground
2 teaspoons baking soda	soda
2 teaspoons cream of tartar	tartar
2 teaspoons ground nutmeg	teaspoons
2 teaspoons grated orange peel	peel
1 teaspoon grated lemon peel	peel
1/2 teaspoon salt	salt
Additional sugar	None
1 cup warm water (110 degrees F)	F
1 egg	egg
3 cups bread flour	flour
1/4 cup white sugar	sugar
3 tablespoons instant powdered milk	tablespoons
1 1/2 teaspoons salt	salt
5 tablespoons butter, softened	butter
1 teaspoon instant yeast	yeast
1/3 cup butter	butter
1/2 cup vanilla ice cream	vanilla
1/2 cup brown sugar	sugar
1/2 cup butter, softened (for spreading)	butter
1 tablespoon ground cinnamon	ground
1/2 cup brown sugar	sugar
1 cup butter, softened	butter
1 cup sugar	sugar
1 cup confectioners' sugar	confectioners
1 cup vegetable oil	oil
2 eggs	eggs
1 teaspoon vanilla extract	extract
4 1/3 cups all-purpose flour	flour
1 teaspoon salt	salt
1 teaspoon baking soda	soda
1 teaspoon ground cinnamon	cinnamon
1 teaspoon cream of tartar	cream
1 cup finely chopped pecans	pecans
Colored sugar (optional)	sugar
2 avocados - peeled, pitted, and mashed	avocados
1/2 tablespoon lime juice	juice
1/2 tablespoon orange juice	juice
1/2 tablespoon pineapple juice	juice
1/4 teaspoon ground cumin	cumin
1/4 cup coarsely chopped cilantro	cilantro
salt to taste	salt
1 teaspoon hot pepper sauce, or to taste (optional)	taste
1 cup unsalted butter	butter
1 cup crunchy peanut butter	butter
1 cup white sugar	sugar
1 cup packed brown sugar	sugar
2 eggs	eggs
2 1/2 cups all-purpose flour	flour
1 teaspoon baking powder	powder
1/2 teaspoon salt	salt
1 1/2 teaspoons baking soda	soda
1 (11 ounce) can mandarin oranges, drained	oranges
1 (8 ounce) can crushed pineapple, drained	pineapple
3 1/2 cups frozen whipped topping, thawed	cups
2 cups shredded coconut	coconut
2 cups miniature marshmallows	marshmallows
1/2 cup milk	milk
1 cup maraschino cherries	cherries
1 1/2 scoops vanilla ice cream	cream
1 1/2 cups milk	milk
1/4 cup whipped cream	cream
2 tablespoons instant hot chocolate mix	mix
5 chocolate sandwich cookies, crushed	cookies
1 1/4 cups all-purpose flour	flour
1/2 cup unsweetened cocoa powder	powder
1/2 teaspoon salt	salt
1/4 cup sliced almonds	almonds
1/4 cup butter, softened	butter
2/3 cup white sugar	sugar
1 egg, beaten	egg
1/2 teaspoon vanilla extract	extract
3/4 cup shortening	shortening
1 cup sugar	sugar
1 egg	egg
1/4 cup molasses	molasses
2 cups all-purpose flour	flour
2 teaspoons baking soda	soda
1 1/2 teaspoons ground ginger	ground
1 teaspoon ground cinnamon	cinnamon
1/2 teaspoon salt	salt
Additional sugar	None
1 1/2 cups white sugar	sugar
4 cups all-purpose flour	flour
1 teaspoon baking powder	powder
1/2 teaspoon baking soda	soda
1/2 teaspoon salt	salt
3/4 teaspoon ground nutmeg	nutmeg
1 teaspoon vanilla extract	extract
2 tablespoons evaporated milk	milk
4 drops red food coloring	coloring
4 pounds dark meat chicken pieces	pieces
1 tablespoon vegetable oil	oil
5 cloves crushed garlic	cloves
1/2 cup all-purpose flour	flour
1 teaspoon poultry seasoning	seasoning
3 (4 ounce) links sweet Italian sausage, sliced	ounce
1 cup chopped onion	onion
3 carrots, sliced	carrots
1/2 pound fresh mushrooms, sliced	mushrooms
1/2 teaspoon dried rosemary	rosemary
1 cup red wine	wine
1 (14.5 ounce) can whole peeled tomatoes	ounce
salt and pepper to taste	taste
1 (8.5 ounce) package corn bread/muffin mix	mix
1 egg	egg
1/3 cup milk	None
2 pounds ground beef	ground
1/2 cup chopped onion	onion
1 (26 ounce) jar meatless spaghetti sauce	sauce
1 cup frozen corn	corn
1 (4 ounce) can chopped green chilies, drained	chilies
2 (1.3 ounce) envelopes sloppy joe mix	ounce
1 cup shredded Cheddar cheese	cheese
1 (12 ounce) package refrigerated biscuit dough	dough
1 (8 ounce) package corn bread mix	mix
1 cup diced onion	onion
1 cup diced celery	celery
1/2 cup butter, softened	butter
1/2 teaspoon salt	salt
1/2 teaspoon ground black pepper	pepper
2 (14.5 ounce) cans chicken broth	ounce
1/8 pound pork sausage	sausage
2 hard-cooked eggs	eggs
1 teaspoon dried sage (optional)	sage
6 large potatoes, peeled and diced	potatoes
1 (12 ounce) can corned beef, cut into chunks	chunks
1 medium onion, chopped	onion
1 cup beef broth	broth
1 (1.5 fluid ounce) jigger vodka	ounce
1/2 fluid ounce cointreau	cointreau
1 teaspoon fresh lime juice	juice
1 1/2 fluid ounces cranberry juice	juice
1 twist lime zest, garnish	zest
1/3 cup all-purpose flour	flour
1 teaspoon garlic salt	salt
1 teaspoon pepper	pepper
1/2 teaspoon paprika	paprika
1/4 teaspoon poultry seasoning	seasoning
1 egg, beaten	egg
1/4 cup 2% milk	milk
2 chicken thighs	thighs
2 chicken drumsticks	drumsticks
canola oil	oil
3/4 cup melted butter, divided	butter
1 pound fresh mushrooms, stems removed	mushrooms
1 cup crushed seasoned croutons	croutons
1 cup shredded mozzarella cheese	cheese
1 (6 ounce) can crabmeat, drained	ounce
1 pound lobster tail, cleaned and chopped	tail
3 tablespoons minced garlic	tablespoons
1/4 cup shredded mozzarella cheese (optional)	cheese
1 cup sour cream	cream
1 cup mayonnaise	mayonnaise
1/2 cup cottage cheese	cheese
1/3 cup hot salsa	salsa
1/4 teaspoon cayenne pepper	pepper
1 tablespoon lemon juice	juice
1/2 cup plain yogurt	yogurt
1 (9 inch) deep dish frozen pie crust	inch
4 eggs	eggs
1 cup heavy cream	cream
1/2 teaspoon salt	salt
1/2 teaspoon black pepper	pepper
3 dashes hot pepper sauce (e.g. Tabasco™), or to taste	taste
1 cup shredded Monterey Jack cheese	cheese
1/4 cup grated Parmesan cheese	cheese
1 (8 ounce) package imitation crabmeat, flaked	ounce
1 green onion, chopped	onion
2 tablespoons olive oil	oil
3 cups fresh chopped mushrooms	mushrooms
2 green onions, chopped	onions
1 clove garlic, crushed	garlic
1/2 teaspoon ground cayenne pepper	pepper
4 ounces cream cheese, softened	cheese
1 (6 ounce) can crabmeat, drained and flaked	ounce
1 (17.5 ounce) package frozen puff pastry sheets, thawed	sheets
6 apples	apples
1 (16 ounce) can whole cranberry sauce	ounce
1/2 cup packed brown sugar	sugar
1/3 cup all-purpose flour	flour
1 1/2 teaspoons ground cinnamon	cinnamon
1/2 teaspoon ground nutmeg	nutmeg
1 recipe pastry for a 9 inch double crust pie	pie
2 cups cherry brandy liqueur	liqueur
1 (16 ounce) can frozen orange juice concentrate	ounce
1 (16 ounce) can frozen lemonade concentrate	ounce
2 quarts cranberry juice	juice
1 (2 liter) bottle lemon-lime flavored carbonated beverage, chilled	beverage
1/4 cup butter	butter
1/2 bunch green onions, chopped	onions
1/2 cup butter	butter
2 pounds frozen crawfish, cleaned	pounds
2 (10.75 ounce) cans condensed cream of potato soup	soup
1 (10.75 ounce) can condensed cream of mushroom soup	soup
1 (15.25 ounce) can whole kernel corn, drained	ounce
4 ounces cream cheese, softened	cheese
2 cups half-and-half cream	cream
1/2 teaspoon cayenne pepper	pepper
1 onion, chopped	onion
1 (10.75 ounce) can condensed tomato soup	ounce
1 (10.75 ounce) can condensed cream of mushroom soup	soup
1 (10 ounce) can diced tomatoes with green chile peppers	peppers
1 1/2 pounds crawfish, peeled	pounds
1 small onion, finely chopped	onion
1 medium tomato, diced	medium
1 stalk celery, chopped	celery
1 green bell pepper, finely chopped	pepper
1 cup shredded Cheddar cheese	cheese
1/4 teaspoon chili powder	powder
1/4 teaspoon salt	salt
4 slices white bread	bread
3 ounces reduced fat cream cheese, softened	cheese
1 cup fat-free milk	milk
1 cup egg substitute	substitute
1/4 teaspoon pepper	pepper
3 cups shredded reduced-fat Cheddar cheese	cheese
1 (10 ounce) package frozen chopped spinach, thawed and squeezed dry	spinach
1 cup frozen chopped broccoli, thawed and well drained	broccoli
1 small onion, finely chopped	onion
5 fresh mushrooms, sliced	mushrooms
1 tablespoon vegetable oil	oil
1 onion, chopped	onion
1 (10 ounce) package frozen chopped spinach, thawed and drained	spinach
5 eggs, beaten	eggs
3 cups shredded Muenster cheese	cheese
1/4 teaspoon salt	salt
1/8 teaspoon ground black pepper	pepper
1 (8 ounce) package cream cheese spread	spread
2 teaspoons ranch salad dressing mix	mix
12 slices pumpernickel rye bread	bread
2 medium cucumbers	cucumbers
1 cup butter	butter
1 cup white sugar	sugar
1 egg	egg
1 1/2 teaspoons vanilla extract	extract
2 1/2 cups sifted all-purpose flour	flour
1/2 teaspoon salt	salt
1 cup rolled oats	oats
1/4 teaspoon peppermint extract	extract
3 drops red food coloring	coloring
2 tablespoons confectioners' sugar	tablespoons
5 (1.5 ounce) bars milk chocolate candy	candy
3 cups cooked, mashed winter squash	squash
1 1/2 tablespoons curry powder	powder
2 tablespoons butter or trans fat-free margarine	margarine
2 tablespoons maple syrup	syrup
1/2 teaspoon Salt, to taste	Salt
1/4 teaspoon cayenne pepper to taste	pepper
3 tablespoons sweetened coconut flakes, toasted (optional)	flakes
1 1/3 cups yellow mustard	mustard
2 (1 ounce) envelopes dry onion soup mix	ounce
1 (5 pound) beef rump roast	pound
1 (3 ounce) package cream cheese, softened	cheese
1 egg	egg
1 medium onion, finely chopped	onion
1/2 cup dry bread crumbs	crumbs
1 1/2 teaspoons dried parsley flakes	flakes
1/2 teaspoon seasoned salt	salt
1/4 teaspoon pepper	pepper
1 pound ground beef	pound
1 pound bulk pork sausage	bulk
8 hamburger buns, split	buns
1 (.25 ounce) package active dry yeast	ounce
2 cups warm water (110 degrees to 115 degrees), divided	degrees
1/3 cup sugar	sugar
2 tablespoons vegetable oil	oil
1 tablespoon salt	salt
1/2 cup rye or whole wheat flour	flour
5 1/2 cups all-purpose flour	flour
3 tablespoons Jamaican jerk seasoning blend	jerk
3 tablespoons vegetable oil	oil
3 cloves garlic, diced	cloves
1 (1 inch) piece peeled fresh ginger, diced	ginger
1 bunch green onions, chopped	onions
12 slices pickled jalapeno peppers	peppers
4 pounds chicken wings	wings
1 cup dates, pitted and chopped	dates
1 cup dark brown sugar	sugar
1/4 cup margarine	margarine
1 cup boiling water	water
1 3/4 cups self-rising flour	flour
1 teaspoon baking soda	soda
2 teaspoons vanilla extract	extract
2 cups sugar	sugar
2 cups all-purpose flour	flour
2 teaspoons baking powder	powder
1/4 teaspoon salt	salt
2 cups chopped dates	dates
2 cups chopped walnuts or pecans	pecans
4 eggs, lightly beaten	eggs
2 tablespoons butter, melted	butter
1 teaspoon vanilla extract	extract
confectioners' sugar	confectioners
3 gallons peanut oil for frying, or as needed	frying
1 (12 pound) whole turkey, neck and giblets removed	giblets
1/4 cup Creole seasoning	seasoning
1 white onion	onion
1 cup shortening	shortening
2 cups all-purpose flour	flour
1 teaspoon salt	salt
1 teaspoon ground black pepper	pepper
1 (2 to 3 pound) whole chicken, cut into pieces	pieces
1/2 cup mayonnaise	mayonnaise
1/2 cup sour cream	cream
1 cup grated Parmesan cheese	cheese
1 (14 ounce) can artichoke hearts, drained	hearts
1/2 cup minced red onion	onion
1 tablespoon lemon juice	juice
salt and pepper to taste	taste
1 pound cubed beef stew meat	meat
1 tablespoon all-purpose flour	flour
2 tablespoons olive oil	oil
2 teaspoons butter	butter
1 medium yellow onion, thinly sliced	onion
1/4 cup red wine	wine
1 beef bouillon cube	cube
1 cup hot water	water
1 large potato, cubed	potato
1/2 cup baby carrots	carrots
1/2 teaspoon rosemary	rosemary
1/2 teaspoon dried thyme	thyme
1/2 tablespoon garlic powder	powder
1/2 teaspoon ground black pepper	pepper
1/4 cup water	water
2 dashes Worcestershire sauce	sauce
2 pounds garlic, peeled	pounds
1 sprig chopped fresh dill	dill
cayenne pepper to taste	pepper
4 1/2 cups distilled white vinegar	vinegar
4 tablespoons salt	salt
1 (3 1/2) pound broiler-fryer chicken, cut up	chicken
1 pound new potatoes, cut into chunks	chunks
2 tablespoons cooking oil	oil
1 cup half-and-half cream	cream
1 teaspoon salt	salt
1/2 teaspoon seasoned pepper	pepper
3/4 cup sliced green onions	onions
1/4 cup chopped fresh dill weed	weed
1/2 cup sour cream	cream
1/2 cup mayonnaise	mayonnaise
2 teaspoons ketchup	ketchup
2 tablespoons prepared horseradish	horseradish
1/4 teaspoon paprika	None
1/4 teaspoon salt	salt
1/8 teaspoon dried oregano	oregano
1 dash ground black pepper	pepper
cayenne pepper to taste	pepper
3 tablespoons soy sauce	sauce
1/2 cup vegetable oil	oil
2 tablespoons sherry	sherry
1 teaspoon grated fresh ginger root	root
2 cloves garlic, peeled and minced	cloves
4 (6 ounce) swordfish steaks	ounce
2 cups white sugar	sugar
1 cup unsweetened cocoa powder	powder
1 cup all-purpose flour	flour
1 cup chopped pecans	pecans
1 cup semisweet chocolate chips	chips
1 medium mango, peeled and finely diced	mango
3/4 cup chopped fresh strawberries	strawberries
1 kiwi, peeled and finely diced	kiwi
1 jalapeno pepper, seeded and finely chopped	pepper
2 tablespoons chopped fresh mint	mint
1/4 cup rum	rum
1 cup all-purpose flour	flour
1/4 teaspoon salt	salt
3 eggs, separated	eggs
3 eggs, separated	cream
1 cup heavy whipping cream	None
1 cup white sugar	sugar
1 cup water	water
1 teaspoon fresh lemon juice	juice
2 tablespoons orange flower water	water
2 cups all-purpose flour	flour
2 tablespoons vegetable oil	oil
1 egg	egg
1/2 teaspoon fresh lemon juice	lemon
1 pinch salt	pinch
1 tablespoon orange flower water	water
4 cups raw almonds	almonds
1 cup sugar	cup
3 eggs	powder
1/2 teaspoon baking powder	teaspoon
1 teaspoon vanilla powder	vanilla
1 lemon, zested	lemon
2 tablespoons orange flower water	tablespoons
cornstarch, for rolling out the dough	dough
pine nuts, for decoration	decoration
Bring 6 cups of water to a boil. 	None
2 (9 inch)  pie shells, baked	shells
3 (8 ounce) packages cream cheese, softened	ounce
1/2 cup white sugar	sugar
1 teaspoon vanilla extract	extract
2 eggs	eggs
1 cup sour cream	cream
3 tablespoons white sugar	tablespoons
2 cups sliced fresh strawberries	strawberries
1 1/2 pounds new potatoes, cut into wedges	wedges
4 tablespoons butter	butter
2 teaspoons fresh rosemary	teaspoons
salt and pepper to taste	taste
1/2 cup mayonnaise	mayonnaise
3 teaspoons milk	milk
1/4 teaspoon salt	salt
1 pinch ground black pepper	pepper
1 pint heavy whipping cream	cream
1/2 cup butter	butter
1 1/2 cups grated Parmesan cheese	cheese
1 1/2 cups quick-cooking oats	oats
3/4 cup all-purpose flour	flour
1/4 teaspoon baking soda	soda
3/4 cup packed brown sugar	sugar
1/2 cup shortening	shortening
2 tablespoons canola oil	oil
1 large eggplant, peeled and sliced	eggplant
3 eggs, beaten	eggs
2 cups dry bread crumbs	crumbs
1 1/2 cups broccoli florets	florets
1 1/2 cups cauliflower florets	florets
1 green bell pepper, cut into 1 inch pieces	pieces
1 cucumber - peeled, seeded and chopped	cucumber
1 carrot, coarsely chopped	carrot
1/4 cup Italian-style salad dressing	salad
Bring a large pot of salted water to boil. 	None
Bring a large pot of salted water to boil. 	None
4 egg whites	whites
1 1/4 cups white sugar	sugar
1 teaspoon vanilla extract	extract
1 teaspoon lemon juice	juice
2 teaspoons cornstarch	cornstarch
1 pint heavy cream	cream
6 kiwi, peeled and sliced	kiwi
4 pounds boneless chuck roast	roast
2 cups water	water
1 (1 ounce) package dry onion and mushroom soup mix	mix
1 tablespoon Worcestershire sauce	sauce
3 potatoes, peeled and chopped	potatoes
2 stalks celery, chopped	celery
2 carrots, chopped	carrots
4 (0.13 ounce) packages unsweetened strawberry-flavored drink mix powder	mix
2 (46 fluid ounce) cans pineapple juice	ounce
3 cups white sugar	sugar
4 quarts water	water
2 liters ginger ale	ale
1/2 cup butter	butter
1 cup water	water
1 cup all-purpose flour	flour
1/4 teaspoon salt	salt
4 eggs	eggs
1 (5 ounce) package instant vanilla pudding mix	ounce
2 1/2 cups cold milk	milk
1 cup heavy cream	cream
1/4 cup confectioners' sugar	sugar
1 teaspoon vanilla extract	extract
2 (1 ounce) squares semisweet chocolate	chocolate
2 tablespoons butter	tablespoons
1 cup confectioners' sugar	confectioners
1 teaspoon vanilla extract	extract
3 tablespoons hot water	water
4 cups half-and-half	None
1 cup white sugar	sugar
11 egg yolks, beaten	yolks
1 teaspoon vanilla extract	extract
2 cups heavy cream	cream
2/3 cup dark rum	rum
1/2 cup Scotch whiskey	whiskey
1 pint vanilla ice cream	cream
6 eggs, beaten	eggs
2 1/4 cups milk	milk
1/3 cup white sugar	sugar
1 teaspoon vanilla extract	extract
1 cup heavy whipping cream	cream
2 teaspoons white sugar	sugar
1 pinch ground nutmeg	nutmeg
1 eggplant, seeded and cut lengthwise into 1/4 inch slices	slices
1 red bell pepper, sliced into thin strips	strips
salt and pepper to taste	taste
1 French baguette	baguette
2 ounces soft goat cheese	cheese
1/4 cup tapenade (olive spread)	spread
1/4 cup grated Parmesan cheese	cheese
2 tablespoons olive oil	oil
2 tablespoons chopped fresh parsley	parsley
2 tablespoons chopped fresh oregano	oregano
2 tablespoons chopped fresh basil	basil
1 tablespoon balsamic vinegar	vinegar
1 teaspoon kosher salt	salt
1/2 teaspoon black pepper	pepper
6 cloves garlic, minced	cloves
1 red onion, cut into wedges	wedges
18 spears fresh asparagus, trimmed	spears
12 crimini mushrooms, stems removed	mushrooms
1 (1 pound) eggplant, sliced into 1/4 inch rounds	rounds
1 red bell pepper, cut into wedges	wedges
1 yellow bell pepper, cut into wedges	wedges
1/2 cup margarine	margarine
1/2 cup sugar	sugar
1/2 cup molasses	molasses
1 egg yolk	yolk
2 cups sifted all-purpose flour	flour
1/2 teaspoon salt	salt
1/2 teaspoon baking powder	powder
1/2 teaspoon baking soda	soda
1/2 teaspoon ground cinnamon	cinnamon
1 teaspoon ground cloves	cloves
1 teaspoon ginger	ginger
1/2 teaspoon ground nutmeg	nutmeg
2 1/4 cups all-purpose flour	flour
2 teaspoons baking soda	soda
1/2 teaspoon salt	salt
6 (1 ounce) squares unsweetened chocolate, chopped	chocolate
1/2 cup unsalted butter	butter
2 1/2 cups dark brown sugar	sugar
3 eggs	eggs
1 1/2 tablespoons vanilla extract	extract
1 cup sour cream	cream
1 cup water	cup
6 (1 ounce) squares unsweetened chocolate, chopped	chocolate
1/4 cup unsalted butter	butter
1 egg yolk	yolk
4 cups confectioners' sugar	confectioners
2 tablespoons vanilla extract	extract
2 tablespoons heavy cream	cream
1 (8 ounce) package cream cheese, softened	cheese
2 cups bittersweet chocolate chips	chips
1 cup heavy cream	cream
1/2 cup butter, softened	butter
1 (3 ounce) package cream cheese	cheese
1 cup sifted all-purpose flour	flour
1 cup fruit preserves	fruit
1/3 cup white sugar	sugar
1 teaspoon ground cinnamon	cinnamon
6 frozen prepared bean and cheese burritos	burritos
2 tablespoons butter or margarine	margarine
3 tablespoons all-purpose flour	flour
1 3/4 cups water	water
1 (8 ounce) can tomato sauce	ounce
1 1/2 teaspoons chili powder	teaspoons
1 teaspoon beef bouillon granules	granules
3/4 teaspoon ground cumin	cumin
1/2 teaspoon salt	salt
2 cups shredded Mexican blend cheese or Cheddar cheese	cheese
1 (2.25 ounce) can sliced ripe olives, drained	olives
1/3 cup chopped green onions	onions
3 eggs	eggs
1/4 teaspoon salt	salt
3/4 cup white sugar	sugar
2 teaspoons vanilla extract	extract
3/4 cup light corn syrup	light
1 cup chopped walnuts	walnuts
1/4 cup butter	cup
1 (9 inch) deep dish pie crust	dish
12 helix snails, without shells	shells
1/2 cup butter, softened	butter
2 cloves garlic, finely chopped	cloves
1 green onion, finely chopped	onion
1 tablespoon finely minced fresh parsley	parsley
1 teaspoon freshly ground black pepper	pepper
1/8 teaspoon ground nutmeg	nutmeg
2 tablespoons dry white wine	wine
12 puff pastry shells	shells
12 mushroom caps	caps
2 tablespoons olive oil, divided	tablespoons
2 (6 ounce) skinless, boneless chicken breast halves	ounce
1 1/2 tablespoons Cajun seasoning	tablespoons
2 cloves garlic, crushed	cloves
1 tablespoon balsamic vinegar	vinegar
1 teaspoon Dijon mustard	mustard
salt and black pepper to taste	taste
2 cups mixed salad greens	greens
1 cup arugula	arugula
1 avocado - peeled, pitted, and diced	avocado
12 oil-packed sun-dried tomatoes, drained and sliced	tomatoes
1/2 cup sliced black olives	olives
8 red apples, cored	apples
1/4 cup butter	butter
1/3 cup maple syrup	syrup
1/2 teaspoon ground cinnamon	cinnamon
1/3 teaspoon ground ginger	ginger
1/2 lemon, juiced	None
1 teaspoon vanilla extract	extract
1/3 cup coarsely chopped walnuts (optional)	walnuts
40 rectangular shortbread cookies	cookies
35 individually wrapped caramels, unwrapped	caramels
1/4 cup water	water
4 cups milk chocolate chips	chips
1 cup water	water
1/4 cup minced fresh parsley	parsley
1 teaspoon sugar	sugar
1/2 teaspoon salt	salt
4 cups Brussels sprouts, halved	sprouts
1 (8 ounce) can water chestnuts, drained and diced	ounce
1 tablespoon butter or margarine	margarine
2 tablespoons vegetable oil	oil
1 medium onion, chopped	onion
1 green bell pepper, chopped	pepper
1 large carrot, peeled and thinly sliced	carrot
3 cloves garlic, minced	cloves
2 (15 ounce) cans black beans	ounce
1 (14 ounce) can chicken broth	ounce
2 cups cubed cooked ham	ham
1/4 teaspoon cumin	cumin
1/2 teaspoon salt	salt
ground black pepper to taste	taste
1 cup shredded Cheddar cheese	cheese
1 cup sour cream	cream
1 cup butter, softened	butter
1/2 cup confectioners' sugar	confectioners
1 teaspoon vanilla extract	extract
2 cups all-purpose flour	flour
1 1/2 cups semisweet chocolate chips	chips
4 teaspoons shortening	shortening
3/4 cup ground walnuts	walnuts
3 cups diced cooked chicken	chicken
2 large stalks  celery, diced	celery
1 red bell pepper, seeded and diced	pepper
1/2 red onion, diced	onion
6 tablespoons mayonnaise	mayonnaise
6 tablespoons sour cream	cream
1 (4 ounce) package feta cheese, crumbled	cheese
2 teaspoons dried dill weed	teaspoons
1 pinch salt and pepper to taste	taste
1 cup corn	corn
1/2 cup diced red onion	onion
1 cup peeled, chopped jicama	jicama
1/2 cup diced red bell pepper	pepper
1 cup fresh cilantro leaves, finely chopped	cilantro
1 lime, zested and juiced	lime
2 tablespoons sour cream	cream
2 tablespoons cayenne pepper	pepper
1 tablespoon ground black pepper	pepper
2 tablespoons salt	salt
6 (4 ounce) fillets tilapia	ounce
2 tablespoons olive oil	oil
12 corn tortillas, warmed	tortillas
1 cup white sugar	sugar
3 eggs	eggs
7/8 cup all-purpose flour	flour
1 teaspoon baking powder	powder
1/8 teaspoon salt	1/8
1/4 teaspoon ground cloves	cloves
1/4 teaspoon ground cinnamon	cinnamon
1/2 teaspoon ground allspice	allspice
1 teaspoon vanilla extract	extract
2 cups chopped dried figs	figs
1 cup chopped walnuts	walnuts
1 cup confectioners' sugar for rolling	confectioners
6 figs, halved	figs
6 ounces goat cheese	cheese
1/2 cup toasted, chopped pecans	pecans
3 slices bacon, cut in half	half
2 cups powdered non-dairy creamer	creamer
1 1/2 cups instant hot chocolate mix	mix
1 1/2 cups instant coffee granules	granules
1 teaspoon ground cinnamon	cinnamon
1/2 teaspoon ground nutmeg	nutmeg
7 slices day-old bread, torn	bread
1 cup torn corn bread	bread
2/3 cup hot water	water
1/2 cup thinly sliced celery	celery
1/2 cup chopped onion	onion
1/2 cup sliced fresh mushrooms	mushrooms
1 tablespoon vegetable oil	oil
1 cup firmly packed sliced fresh spinach	spinach
1 cup cooked long-grain rice	rice
1/2 cup cooked wild rice	rice
1/2 cup orange juice	juice
1 egg, beaten	egg
2 teaspoons rubbed sage	sage
1/2 teaspoon dried thyme	thyme
1/2 teaspoon salt	salt
1/4 teaspoon sugar	sugar
1/4 teaspoon pepper	pepper
1 1/3 cups water	water
2 tablespoons butter, softened	butter
3 tablespoons honey	honey
1 1/2 cups bread flour	flour
1 1/3 cups whole wheat bread flour	wheat
1 teaspoon salt	salt
1 teaspoon active dry yeast	yeast
1/2 cup flax seeds	seeds
1/2 cup sunflower seeds	seeds
1 recipe pastry for a 9 inch double crust pie	pie
1 (21 ounce) can apple pie filling	ounce
1/4 teaspoon ground cinnamon	cinnamon
1/4 teaspoon ground nutmeg	nutmeg
1 teaspoon lemon zest	zest
1 egg	egg
1/3 cup white sugar	sugar
1 tablespoon lemon juice	juice
3 ounces cream cheese	cheese
1/4 cup sour cream	cream
1/4 cup butter	butter
1 pound leeks, chopped	leeks
1 onion, chopped	onion
2 quarts water	water
3 large potatoes, chopped	potatoes
2 large carrots, chopped	carrots
1 bunch fresh asparagus, trimmed and cut into 1 inch pieces	pieces
1/3 cup uncooked long-grain white rice	rice
4 teaspoons salt	salt
1/2 pound fresh spinach	spinach
1 cup heavy cream	cream
1 1/2 cups vegetable oil	oil
2 cups white sugar	sugar
3 eggs, beaten	eggs
2 teaspoons vanilla extract	extract
3 cups all-purpose flour	flour
1 teaspoon baking soda	soda
1 teaspoon salt	salt
1/2 teaspoon ground cinnamon	cinnamon
1/2 teaspoon ground nutmeg	nutmeg
2 1/2 cups apples - peeled, cored and diced	apples
1 cup chopped walnuts	walnuts
1 cup raisins (optional)	raisins
1 (16 ounce) container cream cheese frosting	ounce
1/4 cup finely chopped walnuts	walnuts
2 tart apples, cored and cubed	apples
4 tablespoons lime juice	juice
1 fresh jalapeno pepper, seeded and sliced	pepper
1 fresh Anaheim chile, seeded and sliced	chile
1/2 medium onion, finely chopped	onion
2 tablespoons coarsely chopped fresh cilantro	cilantro
1/2 cup chopped walnuts, lightly toasted	walnuts
2 tablespoons fresh ginger, peeled and thinly sliced	ginger
1/4 teaspoon salt	salt
3 cups all-purpose flour	flour
1 teaspoon baking soda	soda
1 teaspoon ground cinnamon	cinnamon
1/2 teaspoon salt	salt
3 apples - peeled, cored and sliced	apples
1 cup white sugar	sugar
1 cup brown sugar	sugar
1 1/4 cups vegetable oil	oil
2 eggs	eggs
2 teaspoons vanilla extract	extract
1 cup chopped walnuts	walnuts
1 pound fresh or frozen cranberries	cranberries
3 quarts cold water	water
2 cups orange juice	juice
2 1/8 cups pineapple juice	juice
1/4 cup lemon juice	juice
2 cups white sugar, or to taste	sugar
1 (3 inch) cinnamon stick	inch
1 teaspoon whole cloves	cloves
1/2 teaspoon whole allspice berries	berries
2 cups all-purpose flour	flour
1/2 cup shortening	shortening
1 teaspoon salt	salt
1/2 cup cold water	water
2 apples	apples
1/3 cup white sugar	sugar
1/2 teaspoon ground cinnamon	cinnamon
1 cup vegetable oil	vegetable
3 quarts peanut oil for frying	frying
2 tablespoons salt	salt
3 tablespoons coarse ground black pepper	pepper
2 tablespoons cayenne pepper	pepper
2 tablespoons garlic salt	salt
2 tablespoons onion salt	salt
2 cups all-purpose flour	flour
6 eggs, beaten	eggs
6 pounds beef ribs, cut into single rib pieces	pieces
1 cup all-purpose flour	flour
2 cups Italian-style seasoned bread crumbs	crumbs
1/2 teaspoon ground black pepper	pepper
1/2 teaspoon cayenne pepper	pepper
2 eggs, beaten	eggs
2 tablespoons water	water
24 chicken tenderloins	tenderloins
2 quarts oil for frying	frying
1 cup mayonnaise	mayonnaise
3 tablespoons prepared horseradish	horseradish
1/2 cup sour cream	cream
1 dash Worcestershire sauce	sauce
3 tablespoons prepared mustard	mustard
4 cups cranberry juice	juice
1 1/2 cups sugar	sugar
1 1/2 cups lemon juice	juice
1 cup orange juice	juice
4 cups ginger ale, chilled	ale
1 quart raspberry sherbet	sherbet
1 cup butter (no substitutes), softened	substitutes
1 cup packed brown sugar	sugar
1 egg yolk	yolk
1 teaspoon vanilla extract	extract
2 cups all-purpose flour	flour
1/4 teaspoon salt	salt
4 (1.55 ounce) bars milk chocolate candy bar, broken into rectangles	rectangles
1/2 cup chopped walnuts	walnuts
8 ounces cream cheese	cheese
1/2 cup marshmallow creme	creme
2 cups frozen whipped topping, thawed	cups
1/4 cup unsweetened pineapple juice	juice
2 (14 ounce) cans sweetened condensed milk	milk
5 cups milk	milk
2 cups heavy cream	cream
2 tablespoons vanilla extract	extract
1/2 teaspoon salt	salt
3 cups chopped strawberries	strawberries
1 2/3 cups sugar	sugar
1 (5 ounce) can evaporated milk	milk
2 tablespoons butter or margarine	margarine
1/2 teaspoon salt	salt
2 3/4 cups miniature marshmallows	marshmallows
2 cups semisweet chocolate chips	chips
1/2 cup coarsely chopped walnuts	walnuts
1/2 cup raisins	raisins
1/4 cup vegetable oil	oil
1/4 cup orange marmalade	marmalade
3 tablespoons cider vinegar	vinegar
3 tablespoons mayonnaise	mayonnaise
2 teaspoons curry powder	powder
1/4 teaspoon hot pepper sauce	sauce
6 cups cubed, cooked chicken	chicken
2 tablespoons golden raisins	raisins
2 tablespoons slivered almonds, toasted	almonds
2 tablespoons minced fresh parsley	parsley
6 large potatoes, cooked, peeled and cubed	potatoes
4 hard-cooked eggs, sliced	eggs
2 celery ribs, sliced	ribs
6 green onions with tops, sliced	tops
6 radishes, sliced	radishes
1 teaspoon salt	salt
1/2 teaspoon pepper	pepper
1 cup butter, softened	butter
1 tablespoon minced garlic	garlic
1/4 cup grated Parmesan cheese	cheese
1 tablespoon garlic salt	salt
1 teaspoon Italian seasoning	seasoning
1/2 teaspoon ground black pepper	pepper
1/4 teaspoon ground paprika	paprika
2 tablespoons peanut oil	oil
6 cloves garlic, minced	cloves
1 teaspoon grated fresh ginger	ginger
1 bunch green onions, chopped	onions
1 teaspoon salt	salt
1 pound boneless skinless chicken breasts, cut into strips	strips
2 onions, thinly sliced	onions
1 cup sliced cabbage	cabbage
1 red bell pepper, thinly sliced	pepper
2 cups sugar snap peas	peas
1 cup chicken broth	broth
2 tablespoons soy sauce	sauce
2 tablespoons white sugar	sugar
2 tablespoons cornstarch	cornstarch
1 cup mayonnaise	mayonnaise
8 ounces sour cream	cream
1 (1 ounce) package garlic and mushroom soup mix	mix
1 (14 ounce) can artichoke hearts, drained and chopped	hearts
1 cup shredded Swiss cheese	cheese
1 (6 ounce) can crab meat, drained	ounce
1 cup applesauce	applesauce
2 (3 ounce) packages cherry gelatin	ounce
1 (12 ounce) can lemon-lime soda	ounce
1 (8 ounce) can crushed pineapple, undrained	pineapple
1 1/2 cups packed brown sugar	sugar
2/3 cup shortening	shortening
1 tablespoon water	water
1 teaspoon vanilla extract	extract
2 eggs	eggs
1 1/2 cups all-purpose flour	flour
1/3 cup unsweetened cocoa powder	powder
1/2 teaspoon salt	salt
1/4 teaspoon baking soda	soda
2 cups semisweet chocolate chips	chips
1/2 cup evaporated milk	cup
1/2 cup white sugar	sugar
1/4 cup shortening	shortening
2 egg yolks, beaten	yolks
1/2 teaspoon vanilla extract	extract
1/2 cup chopped pecans	pecans
1/2 cup flaked coconut	coconut
1 (4 ounce) bar German sweet chocolate, chopped	ounce
1/3 cup milk	milk
4 ounces cream cheese, softened	cheese
2 tablespoons white sugar	sugar
1 (12 ounce) container frozen whipped topping, thawed	ounce
1 (9 inch) prepared graham cracker crust	inch
4 boneless, skinless chicken breast halves	halves
1 tablespoon vegetable oil	oil
1 onion, chopped	onion
1 (10 ounce) can diced tomatoes with green chile peppers	peppers
1 (14.5 ounce) can stewed tomatoes	tomatoes
12 small chile peppers, diced  (optional)	peppers
1 (10.75 ounce) can condensed cream of chicken soup	soup
1 (14.5 ounce) can chicken broth	ounce
1 bunch green onions, chopped	onions
1/2 pint heavy cream	cream
6 (6 inch) corn tortillas	inch
3 cups shredded Cheddar cheese	cheese
1 (10 ounce) can enchilada sauce	ounce
1 cup chopped peeled mango	mango
1/4 cup chopped red onion	onion
1/4 cup minced fresh cilantro	cilantro
1/4 cup lime juice	juice
2 tablespoons minced fresh mint	mint
1 tablespoon minced fresh ginger root	root
1/2 teaspoon olive oil	oil
1/4 teaspoon salt	salt
2 cups pineapple juice	juice
1 tablespoon cornstarch	cornstarch
2 tablespoons light soy sauce (50% less sodium)	%
1 1/2 tablespoons white vinegar	vinegar
2 garlic cloves, crushed	cloves
3 tablespoons minced fresh ginger	ginger
1 1/4 pounds raw firm fish, such as salmon, tuna or halibut, cut in chunks	chunks
4 cups fresh pineapple in large chunks (or substitute canned pineapple chunks)	chunks
1 large red onion, cut in wedges	wedges
1 (8 pound) bone-in shank ham	pound
4 cups water, or as needed	water
1/2 cup honey	honey
1/2 cup brown sugar	sugar
2 tablespoons liquid smoke flavoring	tablespoons
2 tablespoons Worcestershire sauce	sauce
1 pinch ground cloves	cloves
6 cups all-purpose flour	flour
2 cups shredded Cheddar cheese	cheese
3 tablespoons sugar	sugar
2 (.25 ounce) packages active dry yeast	ounce
2 teaspoons salt	salt
2 cups warm milk	milk
1 egg	egg
4 skinless, boneless chicken breast halves	halves
1 cup milk	milk
1 cup dry bread crumbs	crumbs
1 cup grated Parmesan cheese	cheese
2 tablespoons chopped fresh parsley	parsley
1 cup olive oil	oil
1 orange, sliced into rounds	rounds
1 cup dry white wine	wine
1/2 cup orange juice	juice
1 (10.5 ounce) can chicken broth	ounce
1/4 cup brandy-based orange liqueur (Grand Marnier®)	Marnier&
2 cups all-purpose flour	flour
2 teaspoons baking soda	soda
1 teaspoon ground cinnamon	cinnamon
2 cups white sugar	sugar
1 cup vegetable oil	oil
3 eggs	eggs
1 teaspoon vanilla extract	extract
1 cup chopped walnuts	walnuts
1 (15 ounce) can crushed pineapple, drained	pineapple
2 cups carrots, grated	carrots
1 cup flaked coconut	coconut
1/2 cup butter	cup
1 cup white sugar	sugar
1/2 cup buttermilk	cup
1 teaspoon vanilla extract	extract
3/4 cup margarine	margarine
1 cup white sugar	sugar
1 egg	egg
1/4 cup molasses	molasses
2 cups all-purpose flour	flour
1 tablespoon ground ginger	ground
1 teaspoon ground cinnamon	cinnamon
2 teaspoons baking soda	soda
1/2 teaspoon salt	salt
1/2 cup white sugar for decoration	decoration
6 russet potatoes	potatoes
1 cup all-purpose flour	flour
1 egg, lightly beaten	egg
1 tablespoon olive oil	oil
1 pinch salt	salt
1 1/2 cups all-purpose flour	flour
1 1/2 cups toasted wheat germ	germ
1 cup quick-cooking oats	oats
1 cup packed brown sugar	sugar
2 teaspoons baking powder	powder
1 teaspoon salt	salt
1/2 cup unsweetened applesauce	applesauce
1/2 cup canola oil	oil
2 egg, lightly beaten	egg
1 cup miniature chocolate chips	chips
1/2 cup chopped walnuts or pecans	pecans